WWWWWWWWWWWWWWWWWWW
WOEEEEEEEWEEEEEEEEW
WEWWEWWWWWWWWWEWWEW
WEEEEEEEEEEEEEEEEEW
WEWWEWEWWWWWEWEWWEW
WEEEEWEEEWEEEWEEEEW
WWWWEWWWEWEWWWEWWWW
WEEEEWEEEEEEEWEEEEW
WWWWEWEWEWEWEWEWWWW
WEEEEEEWEEEWEEEEEEW
WWWWEWEWWWWWEWEWWWW
WEEEEWEEEEEEEWEEEEW
WWWWEWEWWWWWEWEWWWW
WEEEPEEEEWEEEEEEEEW
WEWWEWWWWWWWWWEWWEW
WEEWEEEEEEEEEEEWEEW
WWEWEWEWWWWWEWEWEWW
WEEEEWEEEWEEEWEEEEW
WWWWWWWWWWWWWWWWWWW
