WWWWWWWWWWWWWWWWWWW
WOEEEEEEEWEEEEEEEEW
WEWWEWWWWWWWWWEWWEW
WEEEEEEEEEEEEEEEEEW
WEWWEWEWWWWWEWEWWEW
WEEEEWEEEWEEEWEEEEW
WWWWEWWWEWEWWWEWWWW
EEEWEWEEEEEEEWEWEEE
WWWWEWEWEWEWEWEWWWW
WEEEEEEWEEEWEEEEEEW
WWWWEWEWWWWWEWEWWWW
EEEWEWEEEEEEEWEWEEE
WWWWEWEWWWWWEWEWWWW
WEEEPEEEEWEEEEEEEEW
WEWWEWWWWWWWWWEWWEW
WEEWEEEEEEEEEEEWEEW
WWEWEWEWWWWWEWEWEWW
WEEEEWEEEWEEEWEEEEW
WWWWWWWWWWWWWWWWWWW
