WWWWWWWWWWWWWWWWWWW
WOEEEEEEEEEEEEEEEEW
WEEEEEEWEEEEEEEEEEW
WWWWWWWWEEEEEEEEEEW
WEEEEEEEEEEEEEEEEEW
WEEEEEEEEEEEEEEEEEW
WEEEEEEEEEEEEEEEEEW
WEEEEEEEWWWWWWWWWWW
WEEEEEEEWEEEEEEEEEW
WEEEEEEEWEEEEEEEEEW
WEEEEEEEWEEEEEEPEEW
WEEEEWEEEEEEEEEEEEW
WWWWEWEWWWWWEWEWWWW
WEEEEEEEEWEEEEEEEEW
WEWWEWWWWWWWWWEWWEW
WEEWEEEEEEEEEEEWEEW
WWEWEWEWWWWWEWEWEWW
WEEEEWEEEWEEEWEEEEW
WWWWWWWWWWWWWWWWWWW
