WWWWWWWWWWWWWWWWWWW
WEEEEEEEEEEEEEEEEEW
WEEEEEWEEEEEEEEEEEW
WEEEEEWEEEEEEEEEEEW
WEEPEEWEEEOEEEEEEEW
WEEEEEWEEEEEEEEEEEW
WEEEEEEEEEEEEEEEEEW
WWWWWWWWWWWWWWWWWWW
WEEEEEEEWEEEEEEEEEW
WEEEEEEEWEEEEEEEEEW
WEEEEEEEWEEEEEEEEEW
WEEEEWEEEEEEEEEEEEW
WWWWEWEWWWWWEWEWWWW
WEEEEEEEEWEEEEEEEEW
WEWWEWWWWWWWWWEWWEW
WEEWEEEEEEEEEEEWEEW
WWEWEWEWWWWWEWEWEWW
WEEEEWEEEWEEEWEEEEW
WWWWWWWWWWWWWWWWWWW
